100
K ==@=X  M
=@ =#=    
==#=!==! =
==      ==
==      ==
==      ==
==   ^  ==
====== *==
=======  =
W    X== T