120
=====      ===================
=K  =      =        +++      =
=  *=      ==    =========   =
= **=       =    =       =   =
===*=       ==   =       = ===
  = =======  =   = ======= =  
  =       =  ==  = =X      =  
  =    X  =   ==!= =       =  
===#=======    =^= =======!===
=   =       ==== =       =/^ =
=   =       =@W  =       =   =
=M  =       ======       =^ T=
=====                    =====