150
=F    =X   ^     =@=
=  =  ============ =
=**=     +++   X  W=
X  =      ^       M=
=  =               =
====================
=K ============X   =
=  ==============  =
=  ============   T=
=  #!/             =